10111
00001
01001
01101
00100
S:0,1
E:4,4
---
1111111111
1000000001
1011010101
1110010001
1000110101
1101100111
1000010100
1111011101
1000000001
1111111111
S:1,1
E:6,9
---
1111111111
1000000001
1101010101
1001010101
1111010111
1001000001
1011110101
0010000101
1000110101
1111111111
S:1,1
E:7,0
---
